55555555555555555555555555555555555555555555555555
55555555555555555555555555555555555555555555555555
55555555555555555555555555555555555555555555555555
55555555555555555555555555555555555555555555555555
55555555555555555555555555555555555555555555555555
55555555555555555555555555555555555555555555655555
55555556555555555555555555555555555555555556265555
55555562655555555555555565555555555555555556265555
55555562655555655555555626555555555555555566266555
55555562655556265555555626555555556555555566266555
55555662665556265555556626655555562655555666266655
55555552555556265555555525555555562655555555255555
55555552555555255555555525555555552555555555255555
11111111111111111111111111111111111111111111111111
00000000000000000000000000000000000000000000000000
44444444444444444444444444444444444444444444444444